RevA1	TAGTCTGGTCAACAAATCATAAAGATATTGG
ForA1	AGACTATAAACTTCAGGGTGACCAAAAAATCA
RevA2	GTCTCTGGTCAACAAATCATAAAGATATTGG
ForA2	CATACATAAACTTCAGGGTGACCAAAAAATCA
RevA3	AGACATGGTCAACAAATCATAAAGATATTGG
ForA3	TGAGATTAAACTTCAGGGTGACCAAAAAATCA
RevA4	CAAGGAGGTCAACAAATCATAAAGATATTGG
ForA4	AGTCATTAAACTTCAGGGTGACCAAAAAATCA
RevA5	AGAGTAGGTCAACAAATCATAAAGATATTGG
ForA5	TTACCTTAAACTTCAGGGTGACCAAAAAATCA
RevA6	TACCGTGGTCAACAAATCATAAAGATATTGG
ForA6	ACCGGTTAAACTTCAGGGTGACCAAAAAATCA
RevA7	CTATGTGGTCAACAAATCATAAAGATATTGG
ForA7	CTTGAATAAACTTCAGGGTGACCAAAAAATCA
RevA8	ATGTCTGGTCAACAAATCATAAAGATATTGG
ForA8	TGTTCTTAAACTTCAGGGTGACCAAAAAATCA
RevA9	CTTGAAGGTCAACAAATCATAAAGATATTGG
ForA9	AAGTCATAAACTTCAGGGTGACCAAAAAATCA
RevA10	GAGACAGGTCAACAAATCATAAAGATATTGG
ForA10	ACGTATTAAACTTCAGGGTGACCAAAAAATCA
RevA11	TCCTCGGGTCAACAAATCATAAAGATATTGG
ForA11	CTTCGGTAAACTTCAGGGTGACCAAAAAATCA
RevA12	GCCGTTGGTCAACAAATCATAAAGATATTGG
ForA12	TAATCGTAAACTTCAGGGTGACCAAAAAATCA
RevB1	CATCCTGGTCAACAAATCATAAAGATATTGG
ForB1	CGCTTATAAACTTCAGGGTGACCAAAAAATCA
RevB2	AAGTTGGGTCAACAAATCATAAAGATATTGG
ForB2	CGATAGTAAACTTCAGGGTGACCAAAAAATCA
RevB3	AACCTTGGTCAACAAATCATAAAGATATTGG
ForB3	CCGTTGTAAACTTCAGGGTGACCAAAAAATCA
RevB4	GTCCGAGGTCAACAAATCATAAAGATATTGG
ForB4	TTAACGTAAACTTCAGGGTGACCAAAAAATCA
RevB5	GAGTTAGGTCAACAAATCATAAAGATATTGG
ForB5	CGCTGTTAAACTTCAGGGTGACCAAAAAATCA
RevB6	CGCGTAGGTCAACAAATCATAAAGATATTGG
ForB6	AAGTAGTAAACTTCAGGGTGACCAAAAAATCA
RevB7	TAAGCGGGTCAACAAATCATAAAGATATTGG
ForB7	ACATCATAAACTTCAGGGTGACCAAAAAATCA
RevB8	CCGAAGGGTCAACAAATCATAAAGATATTGG
ForB8	TCAACTTAAACTTCAGGGTGACCAAAAAATCA
RevB9	ACCTATGGTCAACAAATCATAAAGATATTGG
ForB9	CACGGATAAACTTCAGGGTGACCAAAAAATCA
RevB10	ACATGTGGTCAACAAATCATAAAGATATTGG
ForB10	CGTGTATAAACTTCAGGGTGACCAAAAAATCA
RevB11	CGTGGAGGTCAACAAATCATAAAGATATTGG
ForB11	AGCTATTAAACTTCAGGGTGACCAAAAAATCA
RevB12	GAACCTGGTCAACAAATCATAAAGATATTGG
ForB12	TCTATGTAAACTTCAGGGTGACCAAAAAATCA
RevC1	GGCACTGGTCAACAAATCATAAAGATATTGG
ForC1	CATGGTTAAACTTCAGGGTGACCAAAAAATCA
RevC2	TCAGATGGTCAACAAATCATAAAGATATTGG
ForC2	CGCAAGTAAACTTCAGGGTGACCAAAAAATCA
RevC3	AACACAGGTCAACAAATCATAAAGATATTGG
ForC3	TGCGTTTAAACTTCAGGGTGACCAAAAAATCA
RevC4	AATCGTGGTCAACAAATCATAAAGATATTGG
ForC4	ATGCTATAAACTTCAGGGTGACCAAAAAATCA
RevC5	CAAGCTGGTCAACAAATCATAAAGATATTGG
ForC5	AGAGTTTAAACTTCAGGGTGACCAAAAAATCA
RevC6	CCATCAGGTCAACAAATCATAAAGATATTGG
ForC6	TTCACTTAAACTTCAGGGTGACCAAAAAATCA
RevC7	TTACAGGGTCAACAAATCATAAAGATATTGG
ForC7	CCTTAATAAACTTCAGGGTGACCAAAAAATCA
RevC8	CGTGTTGGTCAACAAATCATAAAGATATTGG
ForC8	CACATTTAAACTTCAGGGTGACCAAAAAATCA
RevC9	GTACTTGGTCAACAAATCATAAAGATATTGG
ForC9	ACCGTGTAAACTTCAGGGTGACCAAAAAATCA
RevC10	GGTACAGGTCAACAAATCATAAAGATATTGG
ForC10	ACGTTATAAACTTCAGGGTGACCAAAAAATCA
RevC11	GCTCCAGGTCAACAAATCATAAAGATATTGG
ForC11	TATAGGTAAACTTCAGGGTGACCAAAAAATCA
RevC12	AGCGTTGGTCAACAAATCATAAAGATATTGG
ForC12	ATCACGTAAACTTCAGGGTGACCAAAAAATCA
RevD1	CATATGGGTCAACAAATCATAAAGATATTGG
ForD1	TGAGTATAAACTTCAGGGTGACCAAAAAATCA
RevD2	TTCGAAGGTCAACAAATCATAAAGATATTGG
ForD2	CCAGATTAAACTTCAGGGTGACCAAAAAATCA
RevD3	TGCGATGGTCAACAAATCATAAAGATATTGG
ForD3	TAGCTTTAAACTTCAGGGTGACCAAAAAATCA
RevD4	GCTTGTGGTCAACAAATCATAAAGATATTGG
ForD4	CTTACGTAAACTTCAGGGTGACCAAAAAATCA
RevD5	TGCTGTGGTCAACAAATCATAAAGATATTGG
ForD5	CTCACATAAACTTCAGGGTGACCAAAAAATCA
RevD6	ATGCTAGGTCAACAAATCATAAAGATATTGG
ForD6	CAATGTTAAACTTCAGGGTGACCAAAAAATCA
RevD7	CATTCAGGTCAACAAATCATAAAGATATTGG
ForD7	TCGTAATAAACTTCAGGGTGACCAAAAAATCA
RevD8	GTTCCTGGTCAACAAATCATAAAGATATTGG
ForD8	TGACCATAAACTTCAGGGTGACCAAAAAATCA
RevD9	AATGAGGGTCAACAAATCATAAAGATATTGG
ForD9	TGCACATAAACTTCAGGGTGACCAAAAAATCA
RevD10	ACGGTTGGTCAACAAATCATAAAGATATTGG
ForD10	ACTTGTTAAACTTCAGGGTGACCAAAAAATCA
RevD11	ATAGGAGGTCAACAAATCATAAAGATATTGG
ForD11	CTATCTTAAACTTCAGGGTGACCAAAAAATCA
RevD12	TACAAGGGTCAACAAATCATAAAGATATTGG
ForD12	CTTCTATAAACTTCAGGGTGACCAAAAAATCA
RevE1	TGTGCAGGTCAACAAATCATAAAGATATTGG
ForE1	ATAGCGTAAACTTCAGGGTGACCAAAAAATCA
RevE2	GAGAGGGGTCAACAAATCATAAAGATATTGG
ForE2	TCAGCATAAACTTCAGGGTGACCAAAAAATCA
RevE3	CGGCATGGTCAACAAATCATAAAGATATTGG
ForE3	CTGATATAAACTTCAGGGTGACCAAAAAATCA
RevE4	TCCACTGGTCAACAAATCATAAAGATATTGG
ForE4	CACTATTAAACTTCAGGGTGACCAAAAAATCA
RevE5	TTGCGTGGTCAACAAATCATAAAGATATTGG
ForE5	CCTGCATAAACTTCAGGGTGACCAAAAAATCA
RevE6	GACTCAGGTCAACAAATCATAAAGATATTGG
ForE6	ACCATATAAACTTCAGGGTGACCAAAAAATCA
RevE7	TGGAGAGGTCAACAAATCATAAAGATATTGG
ForE7	ATTCCGTAAACTTCAGGGTGACCAAAAAATCA
RevE8	CCTGAGGGTCAACAAATCATAAAGATATTGG
ForE8	TGGAGGTAAACTTCAGGGTGACCAAAAAATCA
RevE9	CTAGTAGGTCAACAAATCATAAAGATATTGG
ForE9	CGACATTAAACTTCAGGGTGACCAAAAAATCA
RevE10	GACACGGGTCAACAAATCATAAAGATATTGG
ForE10	AACCGATAAACTTCAGGGTGACCAAAAAATCA
RevE11	ATGATGGGTCAACAAATCATAAAGATATTGG
ForE11	AGTACATAAACTTCAGGGTGACCAAAAAATCA
RevE12	AGACCGGGTCAACAAATCATAAAGATATTGG
ForE12	TAGGATTAAACTTCAGGGTGACCAAAAAATCA
RevF1	TGGTCAGGTCAACAAATCATAAAGATATTGG
ForF1	TCTCATTAAACTTCAGGGTGACCAAAAAATCA
RevF2	ACCTTGGGTCAACAAATCATAAAGATATTGG
ForF2	TACTCTTAAACTTCAGGGTGACCAAAAAATCA
RevF3	GCATGGGGTCAACAAATCATAAAGATATTGG
ForF3	CGTTATTAAACTTCAGGGTGACCAAAAAATCA
RevF4	CTACATGGTCAACAAATCATAAAGATATTGG
ForF4	TTCAGATAAACTTCAGGGTGACCAAAAAATCA
RevF5	ACCTCAGGTCAACAAATCATAAAGATATTGG
ForF5	CGAACGTAAACTTCAGGGTGACCAAAAAATCA
RevF6	GTTGTAGGTCAACAAATCATAAAGATATTGG
ForF6	CTTCATTAAACTTCAGGGTGACCAAAAAATCA
RevF7	TCTAGAGGTCAACAAATCATAAAGATATTGG
ForF7	TATGGATAAACTTCAGGGTGACCAAAAAATCA
RevF8	CTACGGGGTCAACAAATCATAAAGATATTGG
ForF8	CCTGAGTAAACTTCAGGGTGACCAAAAAATCA
RevF9	CGTTATGGTCAACAAATCATAAAGATATTGG
ForF9	TGGTATTAAACTTCAGGGTGACCAAAAAATCA
RevF10	GCGGTAGGTCAACAAATCATAAAGATATTGG
ForF10	CGGCAATAAACTTCAGGGTGACCAAAAAATCA
RevF11	TTCGGTGGTCAACAAATCATAAAGATATTGG
ForF11	CTCTGATAAACTTCAGGGTGACCAAAAAATCA
RevF12	TCACAAGGTCAACAAATCATAAAGATATTGG
ForF12	CCAACATAAACTTCAGGGTGACCAAAAAATCA
RevG1	GAGCGAGGTCAACAAATCATAAAGATATTGG
ForG1	ATCGAGTAAACTTCAGGGTGACCAAAAAATCA
RevG2	GCTGATGGTCAACAAATCATAAAGATATTGG
ForG2	TGAGCGTAAACTTCAGGGTGACCAAAAAATCA
RevG3	ATCCATGGTCAACAAATCATAAAGATATTGG
ForG3	ACTCGATAAACTTCAGGGTGACCAAAAAATCA
RevG4	ACGACGGGTCAACAAATCATAAAGATATTGG
ForG4	CAGACGTAAACTTCAGGGTGACCAAAAAATCA
RevG5	TTAGTGGGTCAACAAATCATAAAGATATTGG
ForG5	AATCTGTAAACTTCAGGGTGACCAAAAAATCA
RevG6	CCACCTGGTCAACAAATCATAAAGATATTGG
ForG6	TGCTTGTAAACTTCAGGGTGACCAAAAAATCA
RevG7	CTGAATGGTCAACAAATCATAAAGATATTGG
ForG7	ACGCAATAAACTTCAGGGTGACCAAAAAATCA
RevG8	TCTTCAGGTCAACAAATCATAAAGATATTGG
ForG8	AGTAAGTAAACTTCAGGGTGACCAAAAAATCA
RevG9	GGAACGGGTCAACAAATCATAAAGATATTGG
ForG9	CGTCCATAAACTTCAGGGTGACCAAAAAATCA
RevG10	TCTGGTGGTCAACAAATCATAAAGATATTGG
ForG10	TGCAGTTAAACTTCAGGGTGACCAAAAAATCA
RevG11	GGATAGGGTCAACAAATCATAAAGATATTGG
ForG11	TCGAATTAAACTTCAGGGTGACCAAAAAATCA
RevG12	CTGCGAGGTCAACAAATCATAAAGATATTGG
ForG12	AATTCGTAAACTTCAGGGTGACCAAAAAATCA
RevH1	TATAGGGGTCAACAAATCATAAAGATATTGG
ForH1	TGCCTATAAACTTCAGGGTGACCAAAAAATCA
RevH2	CCAGAAGGTCAACAAATCATAAAGATATTGG
ForH2	CAGAGTTAAACTTCAGGGTGACCAAAAAATCA
RevH3	TTGACTGGTCAACAAATCATAAAGATATTGG
ForH3	TTCGTATAAACTTCAGGGTGACCAAAAAATCA
RevH4	CTACCAGGTCAACAAATCATAAAGATATTGG
ForH4	ACTACGTAAACTTCAGGGTGACCAAAAAATCA
RevH5	AAGTCAGGTCAACAAATCATAAAGATATTGG
ForH5	CACTCGTAAACTTCAGGGTGACCAAAAAATCA
RevH6	GGTATGGGTCAACAAATCATAAAGATATTGG
ForH6	TGTCGATAAACTTCAGGGTGACCAAAAAATCA
RevH7	GGATCTGGTCAACAAATCATAAAGATATTGG
ForH7	TCGCTGTAAACTTCAGGGTGACCAAAAAATCA
RevH8	ACAACTGGTCAACAAATCATAAAGATATTGG
ForH8	AGCGTATAAACTTCAGGGTGACCAAAAAATCA
RevH9	ATACCTGGTCAACAAATCATAAAGATATTGG
ForH9	TGAAGATAAACTTCAGGGTGACCAAAAAATCA
RevH10	GGAATAGGTCAACAAATCATAAAGATATTGG
ForH10	CTAGCATAAACTTCAGGGTGACCAAAAAATCA
RevH11	ACTGAAGGTCAACAAATCATAAAGATATTGG
ForH11	AGCATGTAAACTTCAGGGTGACCAAAAAATCA
RevH12	AGCCTAGGTCAACAAATCATAAAGATATTGG
ForH12	TCTTGATAAACTTCAGGGTGACCAAAAAATCA
